S0000000
00000000
000H0000
00000H00
000H0000
0HH000H0
0H00H0H0
000H000G