S0H00000
0H000000
000H0000
00G0H000
000H0000
0HH000H0
0H00H0H0
000H0000