S0H000HG
0H0000H0
000H00H0
0H00H0H0
000H0000
0HH000H0
0H00H0H0
000H0000